Name
Base Map
Map
9 9
X;X;X;X;X;X;X;X;X
I; ; ; ; ; ; ;k;X
X; ; ; ; ; ; ; ;X
X; ; ; ; ; ; ; ;X
X; ; ; ; ; ; ; ;X
X; ; ; ; ; ; ; ;X
X; ; ; ; ; ; ; ;X
X; ; ; ; ; ; ; ;X
X;X;X;X;X;X;X;X;X
Hero
7 1
Ogre
3
1 1
2 1
3 1
Name
gaskd
Map
10 10
X;X;X;X;X;X;X;X;X;X
X; ; ; ;X;X; ; ; ;X
X;I;I;X;X; ; ; ; ;X
X; ; ;I; ; ; ;X; ;X
X; ;k;I;I; ; ;X; ;X
I; ; ; ; ;I; ; ; ;X
X; ; ; ;X;I; ; ; ;X
X; ; ; ; ; ;I; ; ;X
X; ; ; ; ; ; ;I; ;X
X;X;X;X;X;I;X;X;X;X
Hero
5 3
Ogre
2
1 3
5 7
