Name
Base Map
Map
9 9
X;X;X;X;X;X;X;X;X
I; ; ; ; ; ; ;k;X
X; ; ; ; ; ; ; ;X
X; ; ; ; ; ; ; ;X
X; ; ; ; ; ; ; ;X
X; ; ; ; ; ; ; ;X
X; ; ; ; ; ; ; ;X
X; ; ; ; ; ; ; ;X
X;X;X;X;X;X;X;X;X
Hero
7 1
Ogre
3
1 1
2 1
3 1
